00000000000000000000000000000000000000
00000000000000000000000000000000000000
00000000000000000000000000110000000000
00000000000000000000000001010000000000
00000000000100000000000011100000000110
00000000000111100000000111000000000110
00000000000011110000000011100000000000
01100000000010010000000001010000000000
01100000000011110000000000110000000000
00000000000111100000000000000000000000
00000000000100000000000000000000000000
00000000000000000000000000000000000000
00000000000000000000000000000000000000
00000000000000000000000000000000000000
00000000000000000000000000000000000000
00000000000000000000000000000000000000
00000000000000000000000000000000000000
01111000000000000000000000000000000000
10001000000000000000000000000000000000
00001000000000000000000000010000000000
00010000000000000000110000111000000000
00000000000000000000010000010000000000
00000000000000000011100000000000000000
00000000000000000010000000000000000000
00000000000000000000000000000000000000
