0000001001
0010000111
0010000100
0010001001
0000010110
0000001000
1010000101
1010100101
1000000011
0001011101
